#########
# O     #
##  X   #
#       #
#       #
#####   #
#   X   #
#     P #
#########